#############
####......E.#
####........#
####........#
#######DD####
####.....####
####.....####
#..#.....####
#..D.....####
#..#.....####
######D######
####.....####
####.....####
####.....####
######D######
######S######
#############
